Threshold,TrainAUC,TestAUC,Test CM,Train CM,NoRain_NoCloud,NoRain_Cloud,Rain_NoCloud,Rain_Cloud,S0train,S1train,S0test,S1test
0,99.0,58.8,"[[5.8144e+03 1.1026e+03]
 [9.4000e+00 4.8000e+00]]","[[27265.2   402.8]
 [    0.     56.8]]",0,34585,0,71,23163,56,11422,15
2,99.0,64.4,"[[3321.   885.2]
 [   6.4    6.6]]","[[16607.4   217.4]
 [    0.     52. ]]",13554,21031,6,65,14090,44,6941,21
4,99.0,58.0,"[[3001.8  844.4]
 [   8.     5. ]]","[[15186.8   198. ]
 [    0.     52. ]]",15354,19231,6,65,12886,42,6345,23
6,99.0,58.6,"[[3043.   505.6]
 [   8.8    4.2]]","[[13985.8   208.6]
 [    0.     52. ]]",16842,17743,6,65,11893,38,5850,27
8,99.0,62.0,"[[2605.  694.]
 [   7.    6.]]","[[12997.2   198.8]
 [    0.     52. ]]",18090,16495,6,65,11051,44,5444,21
10,98.8,65.4,"[[2765.4  408.8]
 [   7.2    5.8]]","[[12484.2   212.6]
 [    0.     52. ]]",18714,15871,6,65,10629,48,5242,17
12,98.8,63.6,"[[2640.2  361.2]
 [   7.8    5.2]]","[[11814.6   191. ]
 [    0.     52. ]]",19578,15007,6,65,10054,44,4953,21
14,98.8,66.8,"[[2599.8  243.2]
 [   7.4    5.6]]","[[11180.8   191.2]
 [    0.     52. ]]",20370,14215,6,65,9522,45,4693,20
16,98.8,64.2,"[[2408.8  328.6]
 [   7.6    5.4]]","[[10757.2   192.4]
 [    0.     52. ]]",20898,13687,6,65,9167,46,4520,19
18,99.0,57.8,"[[2406.8  201.4]
 [   9.6    3. ]]","[[10260.4   172.4]
 [    0.     50.4]]",21544,13041,8,63,8737,42,4304,21
20,99.0,59.6,"[[2318.   170.2]
 [   9.2    3.4]]","[[9793.   159.8]
 [   0.    50.4]]",22144,12441,8,63,8331,46,4110,17
22,99.0,62.8,"[[2182.6  200.2]
 [   8.     4.4]]","[[9393.6  137.6]
 [   0.    49.6]]",22671,11914,9,62,7979,44,3935,18
24,99.0,61.2,"[[2189.2  140.8]
 [   8.8    3.6]]","[[9194.4  125.6]
 [   0.    49.6]]",22935,11650,9,62,7811,36,3839,26
26,99.0,59.8,"[[2059.   199. ]
 [   8.8    3.6]]","[[8902.   130. ]
 [   0.    49.6]]",23295,11290,9,62,7562,43,3728,19
28,99.0,61.2,"[[1901.   275.4]
 [   8.     4.4]]","[[8579.2  126.4]
 [   0.    49.6]]",23703,10882,9,62,7287,45,3595,17
30,98.8,57.6,"[[1994.8  114.4]
 [   9.8    2.6]]","[[8301.6  135.2]
 [   0.    49.6]]",24039,10546,9,62,7070,37,3476,25
32,99.0,58.2,"[[1870.2  176.6]
 [   9.2    3.2]]","[[8076.8  110.4]
 [   0.    49.6]]",24351,10234,9,62,6862,36,3372,26
34,99.0,57.6,"[[1834.   107.8]
 [   9.2    2.6]]","[[7679.4   87.8]
 [   0.    47.2]]",24876,9709,12,59,6496,48,3213,11
36,99.0,60.0,"[[1703.8  142. ]
 [   8.4    3.4]]","[[7292.    91.2]
 [   0.    47.2]]",25356,9229,12,59,6183,39,3046,20
38,99.0,60.6,"[[1664.2  109.6]
 [   8.4    3.4]]","[[7010.4   84.8]
 [   0.    47.2]]",25716,8869,12,59,5938,43,2931,16
40,99.0,59.0,"[[1535.   115.2]
 [   7.8    2.8]]","[[6523.    77.8]
 [   0.    42.4]]",26334,8251,18,53,5522,41,2729,12
42,99.0,72.0,"[[1569.    45. ]
 [   4.4    4. ]]","[[6397.8   58.2]
 [   0.    33.6]]",26515,8070,29,42,5408,27,2662,15
44,99.0,68.6,"[[1528.4   52. ]
 [   5.     3.4]]","[[6266.8   54.8]
 [   0.    33.6]]",26683,7902,29,42,5293,29,2609,13
46,99.0,69.8,"[[1464.2   58.6]
 [   4.6    3.8]]","[[6037.2   54. ]
 [   0.    33.6]]",26971,7614,29,42,5097,32,2517,10
48,99.0,71.0,"[[1419.4   45.8]
 [   4.6    3.8]]","[[5814.6   46.2]
 [   0.    33.6]]",27259,7326,29,42,4904,32,2422,10
50,99.0,67.4,"[[1353.4   49.4]
 [   5.     3.4]]","[[5563.4   47.8]
 [   0.    33.6]]",27571,7014,29,42,4700,27,2314,15
52,99.0,65.8,"[[1263.2   96.4]
 [   5.     3.4]]","[[5391.    47.4]
 [   0.    33.6]]",27787,6798,29,42,4555,27,2243,15
54,99.0,69.2,"[[1229.8   72.2]
 [   4.6    3.8]]","[[5160.8   47.2]
 [   0.    33.6]]",28075,6510,29,42,4356,33,2154,9
56,99.0,70.4,"[[1186.    68. ]
 [   4.4    4. ]]","[[4967.6   48.4]
 [   0.    33.6]]",28315,6270,29,42,4204,25,2066,17
58,99.0,69.2,"[[1131.2   60.6]
 [   4.4    3.8]]","[[4726.8   40.4]
 [   0.    32.8]]",28626,5959,30,41,3993,27,1966,14
60,99.0,67.4,"[[1054.8   74.6]
 [   4.8    3.4]]","[[4482.6   35. ]
 [   0.    32.8]]",28938,5647,30,41,3786,24,1861,17
62,99.0,64.8,"[[1027.    64. ]
 [   5.2    3. ]]","[[4333.8   30.2]
 [   0.    32.8]]",29130,5455,30,41,3652,30,1803,11
64,99.0,67.2,"[[985.8  71.6]
 [  4.8   3.4]]","[[4203.4   26.2]
 [   0.    32.8]]",29298,5287,30,41,3537,32,1750,9
66,99.0,67.0,"[[949.   65.2]
 [  4.8   3.4]]","[[4027.6   29.2]
 [   0.    32.8]]",29514,5071,30,41,3396,29,1675,12
68,99.0,70.8,"[[891.   65.6]
 [  4.2   4. ]]","[[3794.    32.4]
 [   0.    32.8]]",29802,4783,30,41,3201,31,1582,10
70,99.0,65.0,"[[827.8  71.2]
 [  5.    3.2]]","[[3567.2   28.8]
 [   0.    32.8]]",30090,4495,30,41,3010,29,1485,12
72,99.0,66.2,"[[783.8  67.2]
 [  4.8   3.4]]","[[3378.2   25.8]
 [   0.    32.8]]",30330,4255,30,41,2845,33,1410,8
74,99.0,65.8,"[[751.   71.2]
 [  4.8   3.4]]","[[3261.4   27.4]
 [   0.    32.8]]",30474,4111,30,41,2751,30,1360,11
76,99.0,65.2,"[[741.4  43.2]
 [  4.6   2.8]]","[[3121.    17.4]
 [   0.    29.6]]",30662,3923,34,37,2632,21,1291,16
78,99.6,65.8,"[[700.6  23.8]
 [  3.4   1.8]]","[[2.8962e+03 1.4000e+00]
 [0.0000e+00 2.0800e+01]]",30963,3622,45,26,2424,20,1198,6
