Threshold,TrainAUC,TestAUC,Test CM,Train CM,NoRain_NoCloud,NoRain_Cloud,Rain_NoCloud,Rain_Cloud,S0train,S1train,S0test,S1test
0,70.8,67.6,"[[2.8542e+03 4.0476e+03]
 [8.0000e-01 1.5200e+01]]","[[1.20586e+04 1.55486e+04]
 [8.00000e-01 6.32000e+01]]",0,34509,0,80,23123,51,11386,29
2,68.8,62.2,"[[1.4592e+03 2.7388e+03]
 [1.4000e+00 1.3200e+01]]","[[6.7200e+03 1.0072e+04]
 [8.0000e-01 5.7600e+01]]",13519,20990,7,73,14063,49,6927,24
4,68.8,62.0,"[[1.3006e+03 2.5384e+03]
 [1.4000e+00 1.3200e+01]]","[[6.1256e+03 9.2304e+03]
 [8.0000e-01 5.7600e+01]]",15314,19195,7,73,12860,49,6335,24
6,70.2,57.2,"[[1328.4 2213.8]
 [   3.2   11.4]]","[[6.2086e+03 7.9602e+03]
 [1.4000e+00 5.7000e+01]]",16798,17711,7,73,11869,46,5842,27
8,71.0,55.6,"[[1246.6 2047.2]
 [   3.6   10.2]]","[[5.7962e+03 7.3790e+03]
 [6.0000e-01 5.4600e+01]]",18040,16469,11,69,11032,48,5437,21
10,71.0,55.2,"[[1209.8 1959.4]
 [   3.6   10.2]]","[[5.6104e+03 7.0664e+03]
 [6.0000e-01 5.4600e+01]]",18663,15846,11,69,10616,47,5230,22
12,70.6,55.4,"[[1116.  1880.8]
 [   3.6   10.2]]","[[5.2238e+03 6.7634e+03]
 [6.0000e-01 5.4600e+01]]",19525,14984,11,69,10032,53,4952,16
14,70.6,54.8,"[[1052.  1786.6]
 [   3.6   10.2]]","[[4.9036e+03 6.4508e+03]
 [6.0000e-01 5.4600e+01]]",20316,14193,11,69,9510,45,4683,24
16,70.6,55.0,"[[ 999.6 1733.4]
 [   3.6   10.2]]","[[4.7064e+03 6.2256e+03]
 [6.0000e-01 5.4600e+01]]",20844,13665,11,69,9152,49,4513,20
18,69.4,57.6,"[[ 972.2 1632.4]
 [   2.8   10.2]]","[[4.3660e+03 6.0524e+03]
 [1.0000e+00 5.1000e+01]]",21486,13023,15,65,8725,43,4298,22
20,69.2,57.2,"[[ 920.  1564.6]
 [   2.8   10.2]]","[[4.0908e+03 5.8476e+03]
 [8.0000e-01 5.1200e+01]]",22086,12423,15,65,8320,46,4103,19
22,70.6,60.0,"[[1027.  1353. ]
 [   2.8    9.6]]","[[4.2908e+03 5.2292e+03]
 [1.2000e+00 4.8400e+01]]",22609,11900,18,62,7976,38,3924,24
24,70.8,60.4,"[[ 973.4 1354. ]
 [   2.4   10. ]]","[[4.1386e+03 5.1710e+03]
 [1.0000e+00 4.8600e+01]]",22872,11637,18,62,7790,48,3847,14
26,70.6,59.8,"[[ 929.2 1326.4]
 [   2.4   10. ]]","[[3.9880e+03 5.0344e+03]
 [1.0000e+00 4.8600e+01]]",23231,11278,18,62,7552,45,3726,17
28,71.0,59.4,"[[ 939.4 1234.6]
 [   3.     9.4]]","[[3.9366e+03 4.7594e+03]
 [1.0000e+00 4.8600e+01]]",23639,10870,18,62,7277,47,3593,15
30,71.0,59.6,"[[ 893.8 1213. ]
 [   2.8    9.6]]","[[3.7772e+03 4.6500e+03]
 [8.0000e-01 4.8800e+01]]",23975,10534,18,62,7056,43,3478,19
32,71.2,60.2,"[[ 860.  1184.6]
 [   2.4   10. ]]","[[3.6464e+03 4.5320e+03]
 [8.0000e-01 4.8800e+01]]",24286,10223,18,62,6856,34,3367,28
34,72.0,60.0,"[[ 842.6 1097.6]
 [   2.6    8.8]]","[[3.6386e+03 4.1222e+03]
 [1.0000e+00 4.4600e+01]]",24808,9701,23,57,6499,38,3202,19
36,73.8,64.0,"[[904.2 940.6]
 [  2.2   8.6]]","[[3.7838e+03 3.5954e+03]
 [1.2000e+00 4.2000e+01]]",25285,9224,26,54,6185,31,3039,23
38,77.8,69.0,"[[1081.2  692.4]
 [   2.2    7.8]]","[[4.2452e+03 2.8492e+03]
 [1.4000e+00 3.8600e+01]]",25641,8868,30,50,5934,41,2934,9
40,77.6,70.2,"[[1016.  633.]
 [   2.    8.]]","[[3.9498e+03 2.6462e+03]
 [1.4000e+00 3.8600e+01]]",26264,8245,30,50,5525,32,2720,18
42,81.0,69.8,"[[1052.   559.8]
 [   2.2    6.6]]","[[4.2088e+03 2.2384e+03]
 [8.0000e-01 3.4400e+01]]",26450,8059,36,44,5396,33,2663,11
44,81.0,66.4,"[[1023.4  554.8]
 [   2.6    6.2]]","[[4.1028e+03 2.2100e+03]
 [8.0000e-01 3.4400e+01]]",26618,7891,36,44,5288,28,2603,16
46,80.6,69.6,"[[978.4 542.2]
 [  2.2   6.6]]","[[3.9570e+03 2.1254e+03]
 [1.0000e+00 3.4200e+01]]",26906,7603,36,44,5085,38,2518,6
48,80.0,69.2,"[[934.6 528.4]
 [  2.2   6.6]]","[[3.7812e+03 2.0708e+03]
 [1.2000e+00 3.4000e+01]]",27194,7315,36,44,4905,25,2410,19
50,85.4,69.8,"[[1111.4  289.2]
 [   3.4    5.4]]","[[4.4198e+03 1.1826e+03]
 [2.4000e+00 3.2800e+01]]",27506,7003,36,44,4691,30,2312,14
52,85.4,69.4,"[[1077.   280.4]
 [   3.4    5.4]]","[[4.2994e+03 1.1302e+03]
 [2.6000e+00 3.2600e+01]]",27722,6787,36,44,4547,29,2240,15
54,85.8,66.2,"[[1015.   285.2]
 [   3.8    4.6]]","[[4.1172e+03 1.0836e+03]
 [2.2000e+00 3.1400e+01]]",28008,6501,38,42,4361,22,2140,20
56,85.8,66.4,"[[978.6 273.6]
 [  3.8   4.6]]","[[3.9606e+03 1.0482e+03]
 [2.2000e+00 3.1400e+01]]",28248,6261,38,42,4196,27,2065,15
58,85.4,67.8,"[[940.4 249.4]
 [  3.6   4.8]]","[[3.7540e+03 1.0052e+03]
 [2.4000e+00 3.1200e+01]]",28560,5949,38,42,3989,24,1960,18
60,85.6,66.4,"[[874.  253.4]
 [  3.6   4.8]]","[[3.545e+03 9.646e+02]
 [2.200e+00 3.140e+01]]",28872,5637,38,42,3776,28,1861,14
62,86.0,65.8,"[[841.  248.2]
 [  3.8   4.6]]","[[3.4286e+03 9.2820e+02]
 [2.0000e+00 3.1600e+01]]",29063,5446,38,42,3646,30,1800,12
64,84.4,67.2,"[[819.  236.6]
 [  3.4   5. ]]","[[3.2956e+03 9.2680e+02]
 [2.6000e+00 3.1000e+01]]",29231,5278,38,42,3538,26,1740,16
66,85.2,66.4,"[[784.2 228.2]
 [  3.6   4.8]]","[[3.1642e+03 8.8540e+02]
 [2.2000e+00 3.1400e+01]]",29447,5062,38,42,3392,27,1670,15
68,84.6,67.4,"[[749.8 205. ]
 [  3.6   4.8]]","[[2.9548e+03 8.6440e+02]
 [2.4000e+00 3.1200e+01]]",29735,4774,38,42,3192,34,1582,8
70,84.6,67.2,"[[694.4 203.2]
 [  3.4   5. ]]","[[2.7804e+03 8.1000e+02]
 [2.4000e+00 3.1200e+01]]",30021,4488,38,42,3003,32,1485,10
72,84.6,67.0,"[[654.8 194.8]
 [  3.4   5. ]]","[[2.5966e+03 8.0180e+02]
 [2.2000e+00 3.1400e+01]]",30261,4248,38,42,2841,33,1407,9
74,84.4,66.6,"[[627.2 193.6]
 [  3.6   4.8]]","[[2.4982e+03 7.8500e+02]
 [2.2000e+00 3.1400e+01]]",30405,4104,38,42,2747,30,1357,12
76,80.2,69.6,"[[585.2 198.6]
 [  2.4   4.6]]","[[2361.   774.2]
 [   3.8   24.2]]",30590,3919,45,35,2629,20,1290,15
78,83.8,63.2,"[[528.6 194.6]
 [  2.4   2.8]]","[[2.1318e+03 7.6100e+02]
 [1.0000e+00 1.9800e+01]]",30893,3616,54,26,2422,18,1194,8
