Threshold,TrainAUC,TestAUC,Test CM,Train CM,NoRain_NoCloud,NoRain_Cloud,Rain_NoCloud,Rain_Cloud,S0train,S1train,S0test,S1test
0,99.0,60.8,"[[6.7044e+03 2.1400e+02]
 [9.6000e+00 3.2000e+00]]","[[27417.2   256.4]
 [    0.     51.2]]",0,34592,0,64,23171,48,11421,16
2,99.0,63.8,"[[4021.4  185. ]
 [   8.6    4.2]]","[[16614.4   211.2]
 [    0.     51.2]]",13560,21032,0,64,14101,33,6931,31
4,99.0,58.2,"[[3.6992e+03 1.4740e+02]
 [1.0000e+01 2.6000e+00]]","[[15228.6   157.8]
 [    0.     50.4]]",15359,19233,1,63,12878,50,6355,13
6,99.0,59.6,"[[3.4138e+03 1.3520e+02]
 [9.6000e+00 3.0000e+00]]","[[14043.8   152.2]
 [    0.     50.4]]",16847,17745,1,63,11886,45,5859,18
8,99.0,59.0,"[[3.171e+03 1.294e+02]
 [9.000e+00 2.600e+00]]","[[13078.8   122.8]
 [    0.     46.4]]",18090,16502,6,58,11057,38,5445,20
10,99.0,61.6,"[[3036.6  139. ]
 [   8.4    3.2]]","[[12584.8   117.6]
 [    0.     46.4]]",18714,15878,6,58,10636,41,5242,17
12,99.0,63.4,"[[2892.   110.8]
 [   8.     3.6]]","[[11891.4   119.8]
 [    0.     46.4]]",19578,15014,6,58,10061,37,4953,21
14,99.0,55.2,"[[2.7388e+03 1.0560e+02]
 [9.8000e+00 1.8000e+00]]","[[11263.6   114. ]
 [    0.     46.4]]",20370,14222,6,58,9533,34,4689,24
16,99.0,62.0,"[[2620.2  118.6]
 [   8.2    3.4]]","[[10842.2   113. ]
 [    0.     46.4]]",20898,13694,6,58,9174,39,4520,19
18,99.0,61.2,"[[2496.6  112.6]
 [   8.2    3.4]]","[[10326.8   110. ]
 [    0.     46.4]]",21546,13046,6,58,8738,41,4308,17
20,99.0,61.0,"[[2397.    92.2]
 [   8.4    3.2]]","[[9853.2  103.6]
 [   0.    46.4]]",22146,12446,6,58,8338,39,4108,19
22,99.0,59.0,"[[2254.8  129.2]
 [   8.4    2.8]]","[[9449.2   86.8]
 [   0.    44.8]]",22672,11920,8,56,7987,36,3933,20
24,99.0,56.0,"[[2.2276e+03 1.0360e+02]
 [9.2000e+00 2.0000e+00]]","[[9237.4   87.4]
 [   0.    44.8]]",22936,11656,8,56,7811,36,3845,20
26,99.0,55.6,"[[2.1592e+03 1.0000e+02]
 [9.2000e+00 2.0000e+00]]","[[8950.8   86. ]
 [   0.    44.8]]",23296,11296,8,56,7567,38,3729,18
28,99.0,59.6,"[[2079.2   98.4]
 [   8.4    2.8]]","[[8629.2   81.2]
 [   0.    44.8]]",23704,10888,8,56,7292,40,3596,16
30,99.0,60.4,"[[2007.8  102.6]
 [   8.2    3. ]]","[[8357.8   83.8]
 [   0.    44.8]]",24040,10552,8,56,7064,43,3488,13
32,99.0,55.0,"[[1.9414e+03 1.0660e+02]
 [9.4000e+00 1.8000e+00]]","[[8115.4   76.6]
 [   0.    44.8]]",24352,10240,8,56,6861,37,3379,19
34,99.0,59.0,"[[1847.2   95.6]
 [   8.2    2.6]]","[[7702.6   68.6]
 [   0.    43.2]]",24878,9714,10,54,6510,34,3204,20
36,99.0,61.8,"[[1757.6   89.2]
 [   7.6    3.2]]","[[7317.6   69.6]
 [   0.    43.2]]",25358,9234,10,54,6187,35,3047,19
38,99.0,61.6,"[[1723.2   51.6]
 [   7.8    3. ]]","[[7025.4   73.8]
 [   0.    43.2]]",25718,8874,10,54,5951,30,2923,24
40,99.0,65.0,"[[1502.2  148.8]
 [   6.     3.8]]","[[6538.8   65.2]
 [   0.    39.2]]",26337,8255,15,49,5538,25,2717,24
42,99.0,65.8,"[[1481.   132. ]
 [   5.6    3.8]]","[[6413.    39. ]
 [   0.    37.6]]",26527,8065,17,47,5406,29,2659,18
44,99.0,71.8,"[[1423.4  156. ]
 [   4.4    5. ]]","[[6274.4   43.2]
 [   0.    37.6]]",26695,7897,17,47,5288,34,2609,13
46,99.0,69.0,"[[1389.8  132. ]
 [   4.8    4.6]]","[[6045.4   41.8]
 [   0.    37.6]]",26983,7609,17,47,5096,33,2513,14
48,99.0,69.2,"[[1338.8  125.4]
 [   5.     4.4]]","[[5815.8   41. ]
 [   0.    37.6]]",27271,7321,17,47,4903,33,2418,14
50,99.0,61.4,"[[1344.6   57.2]
 [   6.8    2.6]]","[[5568.2   39. ]
 [   0.    37.6]]",27583,7009,17,47,4694,33,2315,14
52,99.0,72.6,"[[1226.6  132. ]
 [   4.     5.4]]","[[5398.2   36.2]
 [   0.    37.6]]",27799,6793,17,47,4557,25,2236,22
54,99.0,63.8,"[[1160.8  140.4]
 [   5.6    3.6]]","[[5177.6   27.2]
 [   0.    36.8]]",28086,6506,18,46,4358,31,2148,15
56,99.0,65.4,"[[1101.6  151.6]
 [   5.2    4. ]]","[[4985.8   27. ]
 [   0.    36.8]]",28326,6266,18,46,4200,29,2066,17
58,99.0,66.4,"[[1038.2  152.6]
 [   4.8    4.4]]","[[4733.6   29.6]
 [   0.    36.8]]",28638,5954,18,46,3989,31,1965,15
60,99.0,66.6,"[[1017.6  111.2]
 [   5.     3.8]]","[[4489.8   25.4]
 [   0.    35.2]]",28948,5644,20,44,3786,24,1858,20
62,99.0,67.0,"[[983.2 107.2]
 [  4.8   4. ]]","[[4337.6   24. ]
 [   0.    35.2]]",29140,5452,20,44,3655,27,1797,17
64,99.0,64.8,"[[947.6 109.2]
 [  5.2   3.6]]","[[4204.6   22.6]
 [   0.    35.2]]",29308,5284,20,44,3540,29,1744,15
66,99.0,63.4,"[[908.  105.6]
 [  5.4   3.4]]","[[4028.2   26.2]
 [   0.    35.2]]",29524,5068,20,44,3399,26,1669,18
68,99.0,62.6,"[[832.4 123.8]
 [  5.4   3.2]]","[[3808.2   16.6]
 [   0.    34.4]]",29811,4781,21,43,3204,28,1577,15
70,99.0,65.4,"[[779.  119.6]
 [  4.6   4. ]]","[[3575.8   18.6]
 [   0.    34.4]]",30099,4493,21,43,3008,31,1485,12
72,99.0,64.6,"[[728.  122.6]
 [  4.6   4. ]]","[[3387.6   14.8]
 [   0.    34.4]]",30339,4253,21,43,2846,32,1407,11
74,99.0,66.6,"[[707.6 114.2]
 [  4.4   4.2]]","[[3271.4   15.8]
 [   0.    34.4]]",30483,4109,21,43,2749,32,1360,11
76,99.0,68.4,"[[705.4  78.6]
 [  4.2   3.8]]","[[3125.2   10.8]
 [   0.    32. ]]",30672,3920,24,40,2628,25,1292,15
78,99.4,67.8,"[[653.6  69.4]
 [  3.6   3. ]]","[[2888.     4. ]
 [   0.    26.4]]",30977,3615,31,33,2419,25,1196,8
