Threshold,TrainAUC,TestAUC,Test CM,Train CM,NoRain_NoCloud,NoRain_Cloud,Rain_NoCloud,Rain_Cloud,S0train,S1train,S0test,S1test
0,99.0,61.8,"[[6.6176e+03 2.9780e+02]
 [1.1200e+01 4.6000e+00]]","[[27267.2   394.4]
 [    0.     63.2]]",0,34577,0,79,23170,49,11407,30
2,98.4,66.4,"[[3959.4  244.6]
 [   9.2    6. ]]","[[16483.8   332.2]
 [    0.     60.8]]",13557,21020,3,76,14085,49,6935,27
4,98.4,66.6,"[[3590.   254. ]
 [   9.     6.2]]","[[15042.6   333.4]
 [    0.     60.8]]",15357,19220,3,76,12877,51,6343,25
6,98.4,63.6,"[[3316.6  229.8]
 [   9.8    5.4]]","[[13906.2   279.4]
 [    0.     60.8]]",16845,17732,3,76,11888,43,5844,33
8,98.4,68.2,"[[3097.8  199. ]
 [   8.6    6.6]]","[[12893.4   293.8]
 [    0.     60.8]]",18093,16484,3,76,11040,55,5444,21
10,98.4,62.2,"[[2967.6  204.4]
 [  10.4    4.8]]","[[12411.2   276.8]
 [    0.     60.8]]",18717,15860,3,76,10625,52,5235,24
12,98.4,65.2,"[[2769.4  229.8]
 [   9.2    6. ]]","[[11738.2   258.6]
 [    0.     60.8]]",19581,14996,3,76,10041,57,4955,19
14,98.4,67.4,"[[2688.4  152.4]
 [   9.     6.2]]","[[11115.6   247.6]
 [    0.     60.8]]",20373,14204,3,76,9516,51,4688,25
16,98.4,63.6,"[[2502.6  232.6]
 [   9.6    5.6]]","[[10687.8   253. ]
 [    0.     60.8]]",20901,13676,3,76,9162,51,4514,25
18,98.4,68.0,"[[2448.4  157.2]
 [   8.6    6.6]]","[[10190.2   232.2]
 [    0.     60.8]]",21549,13028,3,76,8720,59,4308,17
20,98.2,62.6,"[[2283.4  202.4]
 [   9.8    5.2]]","[[9716.   227.2]
 [   0.    60. ]]",22148,12429,4,75,8329,48,4100,27
22,98.4,65.2,"[[2224.4  156. ]
 [   9.2    5.6]]","[[9309.2  212.4]
 [   0.    59.2]]",22675,11902,5,74,7971,52,3931,22
24,98.8,60.0,"[[2186.6  141.4]
 [  10.6    3.8]]","[[9161.6  150.4]
 [   0.    57.6]]",22937,11640,7,72,7797,50,3843,22
26,98.8,58.6,"[[2095.6  160.4]
 [  10.8    3.6]]","[[8871.6  152.4]
 [   0.    57.6]]",23297,11280,7,72,7555,50,3725,22
28,98.8,60.4,"[[2039.6  134.8]
 [  10.2    4.2]]","[[8543.   154.6]
 [   0.    57.6]]",23705,10872,7,72,7285,47,3587,25
30,98.8,61.8,"[[1992.8  114.8]
 [   9.8    4.2]]","[[8303.   127.4]
 [   0.    56. ]]",24039,10538,9,70,7058,49,3480,21
32,98.8,63.2,"[[1930.2  115. ]
 [   9.4    4.6]]","[[8049.6  131.2]
 [   0.    56. ]]",24351,10226,9,70,6851,47,3375,23
34,99.0,61.0,"[[1871.2   69.8]
 [   9.2    3.4]]","[[7689.2   74.8]
 [   0.    50.4]]",24872,9705,16,63,6494,50,3211,13
36,99.0,64.4,"[[1763.8   81.2]
 [   8.2    4.4]]","[[7298.4   81.6]
 [   0.    50.4]]",25352,9225,16,63,6181,41,3044,22
38,99.0,62.0,"[[1719.2   53.8]
 [   9.     3.6]]","[[7013.8   78.2]
 [   0.    50.4]]",25712,8865,16,63,5941,40,2924,23
40,99.0,60.8,"[[1606.6   41.6]
 [   9.4    3.2]]","[[6514.8   78. ]
 [   0.    50.4]]",26336,8241,16,63,5522,41,2719,22
42,99.0,63.0,"[[1580.6   30.2]
 [   8.4    3.2]]","[[6373.4   69.8]
 [   0.    46.4]]",26523,8054,21,58,5387,48,2667,10
44,99.0,67.8,"[[1519.6   57.6]
 [   7.     4.6]]","[[6238.8   70. ]
 [   0.    46.4]]",26691,7886,21,58,5277,45,2609,13
46,99.0,63.2,"[[1482.4   37.2]
 [   8.2    3.4]]","[[6012.8   65.6]
 [   0.    46.4]]",26979,7598,21,58,5087,42,2511,16
48,99.0,61.2,"[[1427.2   34.8]
 [   8.6    3. ]]","[[5787.    61. ]
 [   0.    46.4]]",27267,7310,21,58,4895,41,2415,17
50,99.0,68.0,"[[1357.    42.6]
 [   7.     4.6]]","[[5535.4   63. ]
 [   0.    46.4]]",27579,6998,21,58,4688,39,2310,19
52,98.8,68.4,"[[1305.6   50.8]
 [   6.8    4.8]]","[[5364.2   61.4]
 [   0.    46.4]]",27795,6782,21,58,4543,39,2239,19
54,99.0,69.8,"[[1254.    44.8]
 [   6.6    5. ]]","[[5136.6   58.6]
 [   0.    46.4]]",28083,6494,21,58,4348,41,2146,17
56,98.8,70.8,"[[1188.2   62.6]
 [   6.2    5.4]]","[[4937.    66.2]
 [   0.    46.4]]",28323,6254,21,58,4189,40,2065,18
58,99.0,61.0,"[[1132.2   59.8]
 [   5.8    2.2]]","[[4740.4   27.6]
 [   0.    32. ]]",28617,5960,39,40,4002,18,1958,22
60,99.0,67.0,"[[1051.    80. ]
 [   3.8    2.8]]","[[4508.    16. ]
 [   0.    26.4]]",28922,5655,46,33,3789,21,1866,12
62,99.0,55.6,"[[1035.6   57. ]
 [   5.4    1.2]]","[[4353.    17.4]
 [   0.    26.4]]",29114,5463,46,33,3658,24,1805,9
64,99.2,62.0,"[[1010.2   48.8]
 [   4.6    2. ]]","[[4218.2   17.8]
 [   0.    26.4]]",29282,5295,46,33,3549,20,1746,13
66,99.0,61.6,"[[962.8  53. ]
 [  4.6   2. ]]","[[4048.4   14.8]
 [   0.    26.4]]",29498,5079,46,33,3397,28,1682,5
68,99.0,59.8,"[[905.6  52.6]
 [  5.    1.6]]","[[3822.8   10. ]
 [   0.    26.4]]",29786,4791,46,33,3211,21,1580,12
70,99.0,59.8,"[[846.2  54.4]
 [  4.8   1.8]]","[[3588.6   13.8]
 [   0.    26.4]]",30074,4503,46,33,3016,23,1487,10
72,99.0,58.6,"[[807.   45.6]
 [  5.    1.6]]","[[3397.6   12.8]
 [   0.    26.4]]",30314,4263,46,33,2859,19,1404,14
74,99.0,61.0,"[[773.2  50.6]
 [  4.6   2. ]]","[[3277.4   17.8]
 [   0.    26.4]]",30458,4119,46,33,2765,16,1354,17
76,99.0,76.6,"[[744.2  42.8]
 [  2.    3. ]]","[[3140.2    7.8]
 [   0.    20. ]]",30642,3935,54,25,2637,16,1298,9
78,99.4,64.4,"[[681.4  44.4]
 [  2.4   1.4]]","[[2.9012e+03 2.0000e+00]
 [0.0000e+00 1.5200e+01]]",30948,3629,60,19,2433,11,1196,8
